buzz	ğŸš£ğŸ»
squared new	ğŸ‘´
sake bottle and cup	ğŸ”²
heat	ğŸ•´
regional indicator symbol letters et	ğŸ˜ƒ
electric torch	ğŸº
convenience store	ğŸ
regional indicator symbol letters ma	ğŸš§
bride	ğŸ¤·
andorran flag	ğŸ˜¿
thumbs down sign	ğŸš¨
spanish flag	ğŸ£
chadian flag	ğŸŒ¹
alcohol	ğŸ‘“
puckered	ğŸ”œ
seeing	ğŸ•
power plug	ğŸ’ƒ
school bag	ğŸ²
caymanian flag	ğŸ˜”
goods	â™ï¸
announcement	âœ¡
regional indicator symbol letters ss	ğŸ™„
slow	ğŸ’
happy cow	â°
bride	ğŸš
crosswalk	ğŸ˜š
octagonal sign	ğŸ¬
hug	ğŸ‡²ğŸ‡º
bell	ğŸ‘
trident emblem	ğŸš·
film	ğŸ¦
raised hand with fingers splayed	ğŸ˜§
black pedestrian	ğŸš­
monster	ğŸ’’
kissy face	âš“
mask face	â™Šï¸
norwegian flag	ğŸ†—
garbage	ğŸ™ˆ
asian	ğŸ‘†
blonde	ğŸš¬
imperial	ğŸ‘…
flag for ghana	ğŸŒˆ
pig	ğŸ†˜
chain	ğŸŠ
thunderbolt	ğŸ¨
regional indicator symbol letters za	ğŸ‘¸
flag for belize	ğŸ“
potable	ğŸ¤¢
fried shrimp	ğŸ›ƒ
powerful	ğŸš®
butter	ğŸ‡¸ğŸ‡¬
spanner	ğŸ
white haircut	ğŸ†
flag for iceland	â™ˆï¸
jewish	ğŸ‘€
musical keyboard	ğŸ‘Œ
rollercoaster	ğŸš°
brass	ğŸ‡ªğŸ‡¹
dancers	ğŸ‡³ğŸ‡¬
north east arrow	ğŸ®
respect	ğŸ·
lemonade	ğŸŒ§
flag for macau	ğŸ«
automated teller machine	ğŸŒº
white flexed biceps	ğŸ´
flag for guatemala	ğŸŒ±
nervous	ğŸ™ŒğŸ¿
queen	ğŸ‘³
christmas island flag	ğŸ‡³ğŸ‡º
light brown surfer	ğŸ’©
double curling loop	ğŸ“¬
flag for falkland islands	ğŸ‡²ğŸ‡µ
golf club	ğŸ˜³
clock face eleven oclock	ğŸ
broken heart	ğŸ“Š
newspaper	ğŸŒ
stub	ğŸŒ
cop car	ğŸ”—
family of two men with one girl and one boy	ğŸ‡·ğŸ‡¸
deeper brown raised fist	ğŸ‘¸
squeans	â™Œ
pet	ğŸ™ğŸ¼
regional indicator symbol letters sc	ğŸ˜
ballerina	ğŸŒ
curry	ğŸ
prints	8ï¸âƒ£
storage	ğŸƒ
father christmas	ğŸš­
lowercase	ğŸ˜–
scooter	â„¹ï¸
flag for norfolk island	ğŸš•
respect	ğŸ
family of two women with one girl	ğŸ
world emoji day	ğŸ‡¹ğŸ‡±
no smoking symbol	ğŸ­
color	ğŸ™
waving white flag	ğŸ‘³ğŸ½
squared katakana koko	âœ
intelligence	ğŸŒŒ
medium white circle	â³
shining star	ğŸ›µ
construction	ğŸ˜£
white swimmer	ğŸ‘…
musical note	â›·
hourglass with flowing sand	ğŸ˜
olive toned face with ok gesture	ğŸ´
crossed swords	ğŸ¼
cantaloupe	ğŸ 
skiing	ğŸƒ
insect	ğŸ¬
dribble	ğŸ‡±ğŸ‡·
large blue circle	ğŸ­
flag for equatorial guinea	ğŸ·
sobbing	ğŸ”
trainer	ğŸ˜‹
flag for tunisia	ğŸ‘Š
xmas tree	ğŸ¦
bolt	ğŸ‘
ghanaian flag	ğŸ½
yen	ğŸ•‘
police cars revolving light	ğŸ‘Œ
æŒ‡	ğŸ£
science	ğŸ‡¦ğŸ‡²
archery	ğŸ¤
knee high boots	ğŸ”Œ
sorrow	ğŸµ
massive	ğŸ‘‹
wild cherry	ğŸ’
libra	ğŸ’¥
money face	ğŸ›©
viewing	ğŸ˜µ
flag for czech republic	ğŸ‘ƒ
deeper brown bride with veil	ğŸŒ€
boys holding hands	ğŸ½
bathers	ğŸ”…
ferry	â›ªï¸
white nail polish	ğŸ˜š
merry go round	ğŸš
flag for cape verde	ğŸš¬
construction	ğŸš·
red devil	ğŸ¹
unlock	âš“
work	ğŸ™
water drop	ğŸ«
cross mark	ğŸ†˜
encouragement	ğŸ˜¿
world map	ğŸµ
regional indicator symbol letters ar	â˜ï¸
mad face	ğŸ¤
game	â¤ï¸
womans boots	ğŸ”•
old key	â›©
summer	ğŸŒƒ
family of a man and woman with one girl and one boy	ğŸ˜œ
regional indicator symbol letters vu	ğŸ”¹
perfect score	ğŸ®
flag for macau	ğŸ¢
handbag	â¬›
bookmark tabs	ğŸ˜¿
purse	ğŸ˜„
flirt	ğŸ«
swimming	ğŸ˜•
no entry sign	ğŸ›µ
void	ğŸ‰
knife weapon	ğŸ‡³
card index dividers	ğŸ…
gold heart	â™‰ï¸
bermudan flag	ğŸš­
artist palette	ğŸ›
astronaut	ğŸ’›
flag for macedonia	ğŸŒ‘
light brown father christmas	ğŸ‘ƒ
flag for ascension island	ğŸ’­
years	â™ˆ
centaur	ğŸ’“
ouch	ğŸ”£
psychic	ğŸ˜˜
jockey	ğŸ˜½
on with exclamation mark with left right arrow above	ğŸŒ
norwegian flag	ğŸ™‡ğŸ¼
sting	ğŸŒŒ
day dream	ğŸ’¦
flag for algeria	ğŸ™€
olive toned person bowing deeply	ğŸ
keycap digit five	ğŸš©
telephone	â™‹ï¸
regional indicator symbol letters gd	ğŸ™ˆ
thick	ğŸ”
church	ğŸ¤”
paper doily	âœˆï¸
moyai statue	ğŸ’©
regional indicator symbol letters ki	ğŸ½
protection	ğŸ‘¹
hugging face	ğŸ’«
uk flag	ğŸ’
notifications	ğŸ‘±ğŸ½
envelope	ğŸ’®
kitty	ğŸ
confused	ğŸ“
person raising both hands in celebration	ğŸ¦„
beating heart	ğŸ®
om symbol	ğŸ‡¹ğŸ‡«
algerian flag	ğŸš£
clinking glasses	ğŸ˜·
adorable	ğŸ‡§ğŸ‡¬
drool	ğŸ™Š
newborn	ğŸ‘‹ğŸ½
capricorn	ğŸ›€ğŸ¿
light brown construction worker	ğŸŒ
folklore	ğŸ¤¦
flag for dominica	ğŸ˜‡
regional indicator symbol letters lb	ğŸŒ¾
regional indicator symbol letters aw	ğŸ˜’
sleeping	ğŸ
andorran flag	ğŸ£
gay couple	â˜®
circle	ğŸ
spare	ğŸ‡µğŸ‡­
autumn	ğŸ‘±
shirt and tie	ğŸ†“
purple crystal	ğŸš’
teacup without handle	ğŸ
military decoration	ğŸ‡µğŸ‡¹
puzzle	ğŸ’
observing	ğŸ‡©ğŸ‡°
playing	ğŸ‘
new york taxi	ãŠ™ï¸
earth globe americas	ğŸš¯
flag for somalia	ğŸš¯
woot	ğŸ¥
soak	#ï¸âƒ£
sashimi	ğŸ˜
fart	ğŸ‘€
win	ğŸ˜ 
crooked	ğŸš¶
prolific	ğŸ‡¬ğŸ‡±
large blue circle	ğŸ’˜
white heavy check mark	î”Š
eyeballs	ğŸ 
little penguin	ğŸ•‹
dark moon	ğŸº
reminder ribbon	ğŸŒ—
hen	ğŸ‡¹ğŸ‡«
drool	ğŸ‘ƒğŸ»
grandpa	ğŸ’²
fletching	ğŸ¤˜
bouquet	â­•
handyman	ğŸ“§
mountain railway	ğŸ’
name badge	ğŸš½
silliness	ğŸš¦
wisdom	ğŸ˜“
shooting	ğŸ˜’
kawaii	ğŸŒ‰
black swimmer	ğŸš¥
sun	ğŸ‘ª
smiling face with open mouth	ğŸš°
keycap digit four	ğŸ”
sunrise	ğŸ‡³ğŸ‡´
kissing face	ğŸ‘
slice of pizza	ğŸŒ
right triangle	ğŸ¨
regional indicator symbol letters na	ğŸ˜´
red flower	ğŸ˜™
yellow	ğŸ³
stairs	ğŸšµğŸ¼
manga meat	ğŸŒ
boiled rice	ğŸ‡¶ğŸ‡¦
hotel	ğŸ“²
beaver	ğŸ™€
shirt	ğŸ‘º
roller coaster	ğŸ˜œ
motion	ğŸŒ´
happy tears cat	ğŸ´
bang	ğŸ’³
christmas	ğŸ’¨
official	ğŸ‘ª
archer	ğŸ‘“
dvd rom	ğŸ
baby change symbol	ğŸ’¯
couple with heart with two women	ğŸ
denim	ğŸ¸
folklore	ğŸ‡«ğŸ‡°
discouraged	â™‘
black white right pointing backhand index	ğŸ‘
anguished face	ğŸ“¡
quarter	ğŸ¤¦
deeper brown thumbs down sign	ğŸ’’
relieved face	ğŸ«
batman	ğŸ’
hands	ğŸ¼
iwazaru	ğŸ‡§ğŸ‡²
chinese camel	ğŸ¥
regional indicator symbol letters gt	ğŸ‚
wild west	ğŸ•
flag for antarctica	ğŸ¾
regional indicator symbol letters uz	ğŸ’«
deeper brown open hands sign	ğŸ”
indian flag	â¹
input symbol for symbols	ğŸ‡°ğŸ‡¾
regional indicator symbol letters ao	ğŸ”
smiling sun	ğŸ•¸
squared free	ğŸ‘…
nicotine	ğŸ‡¸ğŸ‡·
troll	ğŸ’”
wedding	ğŸ·
regional indicator symbol letters sr	ğŸ‡µğŸ‡¬
flag for curaÃ§ao	ğŸ™€
flag for eritrea	ğŸ½
travel	ğŸ’¸
dejected	ğŸ‘¹
easter island	ğŸ›µ
kermit	â™¥ï¸
wallet	ğŸ‡­ğŸ‡¹
black question mark ornament	ğŸ¤µ
clap	ğŸ‡¼ğŸ‡¸
christmas tree	ğŸ‡¸ğŸ‡¸
granny	â„¹ï¸
romance	ğŸ’©
rhinoceros	ğŸ˜‰
marshallese flag	ğŸ‘¤
cake with candles	ğŸ‘
teddy bear	ğŸ‡®ğŸ‡±
strong	ğŸ½
squeans	ğŸ©
regional indicator symbol letters sz	ğŸ‡
medal	ğŸ—
shaking hands	ğŸ˜µ
meow	ğŸ
think	ğŸŒš
purchase	ğŸŒ¡
regional indicator symbol letters ga	ğŸš¼
flag for chad	ğŸ¨
flag for chad	ğŸ„
pain	ğŸ’·
flag for antarctica	ğŸ˜Ÿ
dominican flag	ğŸšš
north west arrow	ğŸƒğŸ¿
surfer	ğŸ’½
softball	ã€½ï¸
cheeks	ğŸ¢
speaking head in silhouette	ğŸ’´
white white down pointing backhand index	ğŸ˜¿
hatching chick	â©
black person frowning	ğŸ¤
granny smith apple	ğŸ¾
regional indicator symbol letters ck	ğŸ©
regional indicator symbol letters si	ğŸ˜¸
vaccination	ğŸ™Š
no water	ğŸ†—
jesus	ğŸ‹
jumbo	ğŸ‘º
symbol input	ğŸƒ
grandstand	â˜ƒ
regional indicator symbol letters cz	ğŸ«
high	ğŸŸ
lemon	ğŸ¸
milky	ğŸŒˆ
sports	ğŸ‰
train platform	ğŸ§
flight	ğŸ˜¢
black open hands sign	ğŸ¹
belarusian flag	ğŸ˜
apple watch	â™’
microphone	ğŸ‘ª
hotdog	ğŸ›¢
flag for angola	ğŸ’·
flag for algeria	ğŸŒ½
vulcan salute	ğŸ‡°ğŸ‡²
lunch box	ğŸ«
lace	ğŸ‘©
wednesday	ğŸ‘¤
scorpion	ğŸ’¦
burned	ğŸŒŒ
flag for antarctica	â™ï¸
hole	âœ‚ï¸
white girl	ğŸ’¥
bees	ğŸ‡¿ğŸ‡¦
train and mountain	ğŸ˜‚
boom	ğŸ‡¬ğŸ‡¾
intense	â„ï¸
acquire	ğŸ’·
discouraged	ğŸ‡µğŸ‡¬
regional indicator symbol letters aw	ğŸ²
disappointed face	ğŸš
flight	â™’
light brown dancer	ğŸš¦
performing	ğŸ›‚
bike	ğŸ˜º
cityscape	ğŸ‡²ğŸ‡¾
camera with flash	ğŸ•›
venezuelan flag	ğŸ†
cancan	ğŸš¾
down arrow envelope	ğŸ‡
luggage	ğŸ‡¬ğŸ‡²
camping tent	ğŸ™‹ğŸ¿
idea	ğŸ’•
oregon	ğŸ£
scary	ğŸ‘
bathers	ğŸ
white face with ok gesture	ğŸŒ½
housecat	ğŸ³
regional indicator symbol letters si	ğŸº
swim	ğŸš˜
ballonfish	ğŸ–¨
gay men	ğŸ‘€
olive toned face massage	â™“
cat	ğŸ‘¤
hops	â™‹ï¸
last quarter moon symbol	ğŸ‘š
aries	ğŸ™€
mad face	ğŸ‘¼
menorah with nine branches	ğŸ‡§ğŸ‡¦
regional indicator symbol letters fr	ğŸ•
phew	â™Š
flag for morocco	ğŸƒ
face with hat	ğŸ‡±ğŸ‡§
mute volume	ğŸŒ•
flag for burkina faso	ğŸ…
alien	ğŸšµ
flag for togo	ğŸº
rocket	ğŸ˜¸
rolodex	ğŸ
double curly loop	ğŸ
cock	ğŸš‹
flag for albania	ğŸ’˜
game	ğŸ
thumbs down	ğŸ’Œ
boutique 109	ğŸ“…
white sun with small cloud	ğŸ…
regional indicator symbol letters tz	ğŸ”’
tramway	ğŸ’œ
golf flag	ğŸŠ
flag for moldova	ğŸ¤—
racing	ğŸ˜¥
power cable	ğŸµ
bermudan flag	ğŸ’Œ
heavy plus sign	ğŸ’†ğŸ¿
humpback whale	ğŸš
halo	ğŸ‘Š
regional indicator symbol letters ge	ğŸŒ—
england	ğŸ’š
poop	ğŸ¬
regional indicator symbol letters kh	âš“
high voltage sign	ğŸŠ
regional indicator symbol letters sy	ğŸ
ano niku	ğŸ‘¸
waning gibbous moon symbol	ğŸ’‚ğŸ¾
perplex	â™Šï¸
flag for sint maarten	ğŸ
hollywood	ğŸ€
www	ğŸ
forbid	ğŸ‘¯
police siren	ğŸ‡
flavor	ğŸ˜
tram	ğŸ™‡ğŸ»
serpent	ğŸ³
police cars revolving light	ğŸŒ–
label	â›”
hearty	ğŸ‘²
carnival	â˜€ï¸
face with medical mask	ğŸŒŠ
seaweed	ğŸŒ‹
flu	ğŸ’œ
mounted	ğŸ“¼
popping corn	ğŸŒ
mask	ğŸ·
campervan	ğŸ“¦
sad devil	ğŸŒš
champagne	ğŸ”‹
regional indicator symbol letters kp	ğŸƒ
regional indicator symbol letters ee	ğŸ‡³ğŸ‡·
winky face	â™Œ
quiet	ğŸ˜·
husk	ğŸ
white haircut	ğŸ“
map pin	ğŸšƒ
banknote with dollar sign	ğŸ­
black person bowing deeply	ğŸ‡®ğŸ‡©
stadium	â™ï¸
women	ğŸ§
firework sparkler	ğŸŒ¸
creme caramel	ğŸº
goodbye	ğŸ¦
regional indicator symbol letter p	ğŸ˜˜
scene	â™Œ
ladybug	ğŸŸ
deeper brown runner	ğŸ˜¢
tennis racquet and ball	ğŸ›©
slice of pizza	ğŸ‘¯
regional indicator symbol letters bo	ğŸ‡²ğŸ‡²
yen	ğŸ¢
flag for lithuania	ğŸ™Œ
pack	ğŸŸ
clock face one oclock	ğŸµ
black pedestrian	âš½ï¸
yearling	ğŸª
big top	ğŸ‹
pistol	ğŸ¼
sweet potato	ğŸ‘‚ğŸ¿
utensil	ğŸ¤
black white up pointing backhand index	ğŸ‘
flag for nepal	â™ˆ
billy goat	ğŸŒœ
pink flower	ğŸƒ
myth	ğŸ‡ªğŸ‡¸
boeing	ğŸ¤
olive toned raised fist	ğŸ¾
frying	ğŸŒ˜
constellation	ğŸš
deck of cards	ğŸ¢
direct	ğŸ•´
flag for sweden	ğŸ†
japanese flag	ğŸ’•
flag for dominican republic	ğŸ˜
ringer disabled	ğŸ“¨
galloping horse	ğŸ»
black princess	ğŸƒ
luck	ğŸŒ
no mobile phones	ğŸš¯
clock face two oclock	âš“ï¸
fugu	ğŸ
sale	ğŸŒ
housecat	ğŸ‘©ğŸ»
flag for british virgin islands	ğŸ’™
olive toned white down pointing backhand index	ğŸœ
light brown information desk person	ğŸ‘“
et	ğŸ­
golfer	ğŸ«
irish flag	ğŸ’ª
karaoke	ğŸ˜¼
yellow	ğŸ‚
gift heart	ğŸ“
envelope with downwards arrow above	ğŸ
delivery truck	ğŸ‘…
small blue diamond	ğŸ˜š
child	ğŸ‡¸ğŸ‡»
flag for saudi arabia	ğŸ’ªğŸ¾
livid	ğŸ
gyro	ğŸ˜·
couch	ğŸ‡²ğŸ‡ª
moyai	ğŸ‡
perspiration	ğŸ‘·ğŸ»
question	ğŸŒ
bleeper	ğŸ”µ
airplane departure	ğŸ‘ŠğŸ¾
seeing	ğŸ”§
savory	ğŸ‘ˆğŸ¿
joint	ğŸŒ¹
black square for stop	ğŸ‡¯
smiling face with smiling eyes	ğŸ‡
boeing	âœ
regional indicator symbol letters tv	ğŸ›
verbalize	ğŸ‡¦ğŸ‡¹
candles	ğŸ§
deeper brown guardsman	ğŸ˜­
builder	ğŸ˜‚
boom	ğŸ˜
big grin	ğŸ‡°ğŸ‡²
yummy	ğŸ‡²ğŸ‡©
frame with picture	ğŸ‘°ğŸ»
sun with face	ğŸ‹
imprints	ğŸŒ´
portland	ğŸ‡²ğŸ‡½
white face with no good gesture	ğŸ“¶
revolver	ğŸ‡§ğŸ‡³
metro	ğŸ˜¨
heart	ğŸ’µ
yeast	ğŸ•
coffin	ğŸ‡²ğŸ‡¾
regional indicator symbol letters cy	â™’ï¸
stride	ğŸ£
grey skull	ğŸ˜¸
waxing gibbous moon symbol	ğŸ‹
go	ğŸ…ğŸ¾
anger symbol	ğŸ¦
construction sign	ğŸƒ
flag for cayman islands	ğŸ¾
hammer and pick	ğŸ’
expressionless	ğŸ”¥
chamorro flag	ğŸ“
flirting	âœˆï¸
meal	ğŸ‡±ğŸ‡»
envious	ğŸ‘·ğŸ¼
flag for mali	ğŸ”¢
grandstand	ğŸ‡³ğŸ‡µ
galloping horse	â
powerboat	ğŸ«
regional indicator symbol letters id	ğŸšŸ
july 17	ğŸŒ€
cake	ğŸ¥’
ear of rice	ğŸ§
sake bottle and cup	ğŸŒ†
white runner	ğŸ©
ham	ğŸ“‡
new years	â™‘
regional indicator symbol letters ge	ğŸ˜Š
android lollipop	ğŸš«
regional indicator symbol letters lu	ğŸ‘
anguish	ğŸ†™
house	ğŸš‰
ringer	Â®ï¸
yellow	ğŸ—
talk	ğŸ’Œ
white ok hand sign	â•
golden delicious apple	ğŸ’«
angry	ğŸ˜’
roast	ğŸ¡
yellow flower	ğŸ’…ğŸ½
appreciation	ğŸš¶
left speech bubble	â™’
rotary phone	ğŸ›
couple with heart with two men	ğŸ”
universe	ğŸ¥
honeybee	ğŸ˜¿
light brown raised fist	ğŸ¥
kernel	ğŸ‘
middle finger	ğŸŒ“
jaws	ğŸš‡
astronaut	ğŸ™€
clear button	ğŸŒ±
regional indicator symbol letters uz	ğŸ†˜
older man	ğŸ±
bowling	ğŸ‡²ğŸ‡ª
guard	ğŸ‡©ğŸ‡¯
block of chocolate	ğŸ´
hard	ğŸ®
discouraged	ğŸŒ™
snapchat mutual best friends	ğŸ˜“
fishing rod	ğŸš”
topper	ğŸ
pina	ğŸ‘°ğŸ¿
flag for united kingdom	ğŸ¯
regional indicator symbol letters sa	ğŸ‡¬ğŸ‡¬
bumble	ğŸ€„ï¸
snowman without snow	ğŸ˜£
obento	ğŸš¡
cry	â‰ï¸
olive toned person bowing deeply	ğŸŒ–
face with hat	ğŸŒƒ
luggage	ğŸ¤
shield	ğŸ˜’
flag for paraguay	ğŸ“
world	ğŸ‘¿
masks	ğŸ¥
nerdy	ğŸ˜¤
yellow bird	ğŸƒğŸ¾
flag for united kingdom	ğŸ‘›
snowboarder	ğŸ‘“
baguette bread	ğŸ¢
tengu	ğŸ“£
moat	ğŸ‡ºğŸ‡¾
dusk city	ğŸ’ƒ
pine decoration	ğŸ‘º
fried	ğŸ»
observing	ğŸ¥
flag for united states	â›ˆ
cocktail	ğŸ‘¸
dollar	ğŸŒ•
rude finger	ğŸ®
regional indicator symbol letters rs	ğŸ‘
flag for tristan da cunha	ğŸ›
scary face	ğŸ’¾
ice hockey	ğŸš·
sisters	ğŸ‘ 
lamb	ğŸ˜“
fearful	ğŸ’†ğŸ»
father	ğŸª
flag for guernsey	ğŸ¤
saint nick	â›
depressed	ğŸ˜‹
endure	ğŸ·
japanese ogre	ğŸŒš
assignment	ğŸ•”
table tennis	ğŸ
draft	ğŸ¼
game die	â™ˆ
strike	ğŸ‘¨ğŸ½
clammy	ğŸ‡§ğŸ‡¸
pocket ball	ğŸ˜»
light	ğŸ›€
motor scooter	â™ï¸
heat	ğŸ˜•
bowl of food	âœˆï¸
white mountain bicyclist	ğŸ“
heavy heart exclamation mark ornament	ğŸ’¼
high five	ğŸ’›
blessing	ğŸ’«
regional indicator symbol letters al	ğŸ´
minivan	ğŸŒ
knife and fork	ğŸ¦€
classic	ğŸ˜œ
groom	ğŸ’®
flagpole	ğŸ™Š
score	ğŸ™
china	ğŸ¥¡
purchase	ğŸ‡µğŸ‡·
putto	ğŸ·
red rose	ğŸš·
andorran flag	ğŸ’·
troll	â™‰
olive toned older woman	ğŸ¶
keycap digit two	ğŸ§
academic	ğŸ‡¬ğŸ‡º
light brown face with ok gesture	ğŸ‘Œ
shew stone	ğŸŒ‡
regional indicator symbol letters mv	ğŸ˜¦
small blue diamond	ğŸ 
american flag	ğŸ™ğŸ¿
meteoroid	ğŸŒˆ
bend	ğŸ°
hinamatsuri	ğŸ‘
easter	ğŸ˜‹
pony	ğŸŒ‘
right triangle	ğŸ
championship trophy	ğŸ‘ƒğŸ¿
slug	ğŸ”
regional indicator symbol letters zw	ğŸ‡ºğŸ‡¬
hwatu	ğŸ‡®ğŸ‡²
flag for zimbabwe	ğŸ‡±ğŸ‡¹
train	ğŸ‘§ğŸ½
8 ball	ğŸ‘ª
pink shirt	ğŸ“ƒ
peel	ğŸ“€
hockey	âœˆï¸
input symbol for numbers	ğŸ„
storage	ğŸ“¹
flying	ğŸ“­
liar	ğŸŒµ
hammer and pick	ğŸŒ³
grey rat	ğŸšµ
playboy	ğŸ’®
woof	ğŸŒ 
berry	ğŸ‰
circled ideograph congratulation	ğŸ‘¸
scared	ğŸŒ›
theater	ğŸ‡±ğŸ‡¹
flag for kuwait	ğŸš­
shinto shrine	ğŸ˜²
pig face	ğŸ‘ª
light brown older woman	ğŸ‡½
silhouettes	ğŸ”’
flag for maldives	ğŸ˜†
thick	ğŸ¸
unique	ğŸ˜¨
regional indicator symbol letters ly	ğŸ’
hugging	ğŸ”
brÃ»lÃ©e	ğŸ¶
croissant	ğŸ“œ
womens symbol	ğŸ˜‚
brown leaves	ğŸš’
regional indicator symbol letters mq	ğŸ†™
pit	ğŸ‘¤
milk	ğŸ«
game	ğŸŒ
hands	ğŸ˜˜
shibuya	ğŸ˜…
donut	ğŸ
roast turkey	ğŸ™€
regional indicator symbol letters aw	ğŸŠ
entertainment	ğŸ™ğŸ¿
treble clef	ğŸ‡§ğŸ‡¿
ç”³	ğŸ”«
mare	ğŸ›ƒ
finals	ğŸ‡·ğŸ‡º
empire apple	ğŸ‘º
members	ğŸ¼
side of taxi	ğŸŒ“
shipyard	ğŸ••
oncoming taxi	ğŸ‡¦ğŸ‡º
fire	ğŸ’’
boarding	ğŸ–¼
bubble	â›µï¸
utensil	ğŸ³
sacrifice	â¤ï¸
flag for palestinian territories	ğŸˆµ
boar	ğŸ’®
regional indicator symbol letters vn	ğŸ›€
cosmonaut	ğŸ¸
airport	ğŸ¨
drop	ğŸ´
regional indicator symbol letters id	â™Œï¸
cute lion	ğŸ†
outbox tray	ğŸƒ
railway	ğŸ‡¸ğŸ‡±
rabbit face	â˜¦
ant	ğŸ‡ªğŸ‡¹
bearskin	ğŸ‡µğŸ‡±
regional indicator symbol letters eg	ğŸ˜
spot	ğŸ˜
white person frowning	ğŸ”—
unicorn	ğŸ“±
fortune teller	ğŸš·
bust in silhouette	ğŸ˜Œ
black heart suit	ğŸš
single bump camel	ğŸ‘Œ
deeper brown boy	ğŸ‘›
grinning face	ğŸ„
scorpius	ğŸ™‡ğŸ¿
white smiling face	ğŸ‡
festival	ğŸ¯
flag for guinea	ğŸ¸
white girl	ğŸ¤˜
tigger	ğŸ‡¨ğŸ‡¾
happy	ğŸª
friendly	ğŸ„
police cars revolving light	ğŸ‡§ğŸ‡ª
four	ğŸ’»
woot	ğŸ¢
lollypop	ğŸ•
flag for ghana	ğŸ“³
womans sandal	âœŠğŸ¼
fido	ğŸ´
grimacing face	ğŸ˜¿
white man with turban	â™
flight	ğŸ‡®ğŸ‡¨
nigerian flag	ğŸ¨
et	ğŸŒ²
thanksgiving turkey	ğŸ®
i am a witness	ğŸ‹
monkey covering eyes	ğŸ•¸
india	ğŸ‘²
alien monster	ğŸ²
surprise	ğŸ¥
daisy	ğŸ™ğŸ¼
sun behind cloud	ğŸ’»
england	âš ï¸
marriage	ğŸ‘
children	ğŸš—
æŒ‡	â˜„
wild pig	ğŸ‘…
top with upwards arrow above	ğŸ…
frustration	ğŸ‡«ğŸ‡¯
scrunched eyes	ğŸš„
dropped pin	ğŸŒ
bar	âœ‹ğŸ½
fiddle	ğŸ•Š
cowgirl boots	ğŸ
black man with gua pi mao	ğŸŒœ
dvd rom	ğŸ€
spanner	ğŸ¨
four	ğŸ’­
regional indicator symbol letters ke	ğŸ 
frying	ğŸ‘°ğŸ»
wide eyes	ğŸŒ°
white dancer	ğŸ‘
sake bottle and cup	ğŸŒ´
mono	ğŸ€
left luggage	ğŸš™
play	ğŸ‰
men	ğŸŒ™
reward	ğŸš«
sake	ğŸ¿
flag for botswana	ğŸš¡
sad tears	ğŸ¤³
girl with crown	ğŸ
flag for liberia	ğŸš
fist pump	ğŸ‘‚ğŸ¾
restaurant	â™‰ï¸
campsite	ğŸ‘¦ğŸ¾
sleepy	ğŸ¬
japanese	ğŸ’¶
celebrate	ğŸ‡³ğŸ‡ª
flag for luxembourg	ğŸ
ant	ğŸŒ
slow	ğŸ‘
growing heart	ğŸ–
steam train	ğŸ©
ballerina	ğŸš
flag for philippines	ğŸ‡§ğŸ‡§
girl	ğŸš”
circled ideograph congratulation	ğŸ˜¤
gem stone	ğŸ’¢
festival	ğŸŒŠ
regional indicator symbol letters sl	ğŸƒ
black flexed biceps	ğŸš“
pouch	ğŸš£ğŸ¼
abcd	ğŸ˜™
black and yellow striped sign	ğŸŒ
jar	ğŸ«
vine	ğŸ“Ÿ
gross	ğŸ˜¡
zip it	ğŸš¢
surprised	ğŸ˜“
ç¦	ğŸŒ¾
violet	ğŸš
flag for ecuador	ğŸ
cocktail	ğŸ‘¶ğŸ¾
canvas	ğŸ”«
deeper brown person with pouting face	5ï¸âƒ£
flag for denmark	â›±
white fisted hand sign	ğŸ‘ª
lemon	ğŸ”ª
boogy	â™“ï¸
keycap ten	ğŸ’§
disappoint	ğŸš¯
alien	ğŸš…
automated teller machine	ğŸ˜´
snapchat mutual best friends	ğŸ¤¤
bellhop	ğŸ’§
minivan	ğŸ›‚
hearty	ğŸ
flag for zambia	ğŸŒ½
black nose	ğŸš´ğŸ½
up down arrow	ğŸ™ğŸ¾
leaf fluttering in wind	ğŸ©
chinese flag	ğŸŒ 
video	ğŸ˜ƒ
lounge	â™‘ï¸
flag for benin	ğŸ™‹
thumb tack	ğŸ“–
kissy face	ğŸ‡·ğŸ‡ª
mongolian flag	ğŸ‘½
restaurant	ğŸ
postbox	ğŸ˜³
happy person raising one hand	ğŸš“
congratulations	ğŸ‘¥
hand with first and second fingers crossed	ğŸ”‰
gibbous	ğŸ™
left speech bubble	ğŸ¤´
black and yellow striped sign	ğŸ‘ğŸ¿
black haircut	âœŒï¸
note	ğŸ‡
dito medio	ğŸ”™
flag for italy	ğŸ°
flag for chile	ğŸšµğŸ»
clear	ğŸ‡µğŸ‡¸
regional indicator symbol letters ml	ğŸ
embarrassed	ğŸ³
indian food	ğŸŒ‚
ringer	ğŸ¤—
regional indicator symbol letters mo	ğŸ˜’
paw	ğŸŒ½
hocho	ğŸš¾
fluttering	ğŸ¡
spanner	ğŸŒƒ
fuel pump	ğŸ‡ªğŸ‡¹
amphora	â˜®
solar eclipse	ğŸ
art	ğŸ˜ƒ
spectacles	ğŸ“¶
pink	ğŸ˜œ
regional indicator symbol letters tr	ğŸ‡ªğŸ‡¸
white square button	âš±
microscope	ğŸ”¤
kissy face	ğŸ”¡
disappointed	ğŸŒ›
diamond shape with a dot inside	ğŸ®
deeper brown person with folded hands	ğŸˆ
caution	ğŸ—„
customs	ğŸ¥
barbadian flag	ğŸ€
micro	ğŸ†
moat	ğŸ’
kitchen knife	ğŸ‡§ğŸ‡«
play	ğŸ
lame	ğŸ³
regional indicator symbol letters de	9ï¸âƒ£
honor	ğŸ¤
regional indicator symbol letters ee	â™ˆ
ping pong	ğŸ
regional indicator symbol letters mw	â™Šï¸
black white left pointing backhand index	â—
spit	ğŸš¥
secret	ğŸŒ†
leopard	ğŸ‘‹
rodent	ğŸ˜­
jazz hands	ğŸ’²
passport	ğŸš¼
drop	ğŸ˜’
cross eyes face	ğŸ‡¯
funicular	ğŸ†˜